B1A	AATGCGGCTTGACC
F7B	ATGGTAATCCAAGG
P23A	ACTGTGCAGCTGAG
F3C	AACCGCCGAGAAGG
BC1	CACATGTATGCACA
F6D	CAAGCCAAGGCGAA
F4A	ACCGCTCCTACAAG
BN2	CCACTTAACTCTGC
B6B	AACCTAGAACCGCG
B6C	CATCTCATAGTGAG
ZC4	CCAACCTGGAGAAG
P5C	CTCCGAACCAGTAC
BJ1	ACACTAGTGCATGA
B1B	CACTACTACAGTGC
B3A	AAGAAGCCATAAGG
FJ4	CACAGCACTCGACA
B8C	CTCCAATGCCATAA
F5B	CCTAAGAACCACAC
F8B	CAACCTGGTGGCAA
B6A	ACTGGAATTGGAGC
F7D	CAACGTGCCATGCG
FC3	CCTACCAGTATGGC
F4C	TAGAAGCTTATTGG
B8B	CTAGCTCTCGTCAG
F2C	TCCGTAACCGTTCA
B8A	ATACGATCGCTACG
B1C	AACCGGTTGTTAGC
B3B	AAGCGCTCTCCAGG
BJ2	TAGGTGAGGCTTGG
F8D	TCAGCGCCGTATGG
B5D	CTCCATAACTGCCA
BC4	CACATAGTCGACGA
F5C	ATAGTCACTAGCAC
F2A	CAACGGAAGTGAAG
FN3	AACCTAGAGAACAA
F6A	TAATGCACTGCGCC
BC2	TTGTCGCCGAGACC
F1A	ACGAGACGTAGCGC
FC4	CACGACACATAGAC
B1D	ATCTGCTGTCGCAC
C5B	ACGCAGTATATGAC
B5C	CAGATCTAGACTGA
P5B	CTATGTAGACAGAG
F1C	CTGCTGCTAGGAAC
FN1	TAGACACGTACTCA
FJ2	ACAACGAAGGTTCC
B6D	ACAAGTTCGGAACC
FJ1	CAGGTTAACCGTAC
B7D	TCATACCGAATTGA
F1B	CCTCTAATGGCCGC
F3A	TCAGTCGAGATAGA
BN4	CACAGTCGTAGTCG
B2A	TAGTCTATGTGAGC
B3D	ACCGAAGCAACTAA
F4D	TACAGCTCACTGAG
F6C	TAGAGCTGAGATCA
B7C	CACACTAGCACTGA
F5A	CATCGATATCTAGA
BN3	ATTGGTTCAAGTCA
F3B	TTCCGTAGGTCTGA
FC1	ACGACACATGCTAC
F6B	TCGCAGCCTAGAAG
F8C	TACGAGTACAGACA
B5B	CTACACTACGAGAC
BJ4	CTATGCATGACGCG
B2B	AAGTGGTTGACTAA
B4A	ATGCATGCGTCAGA
BN1	CCATAACCGGATCC
F4B	ATGTTCCTGGTTGA
F2D	ATAGACGTCGTGCG
F7A	ACCTGGAGAGATAG
BC3	TAGCGTTAGTGGAA
F2B	TATTCGTTATCGGC
ZC1	CACACGTCTCGTAG
B5A	TTGAATATCTGTCC
F5D	TACATGCGTCTGCA
B8D	TAATATCAAGGTCC
C5C	CTGAGTGCTGGCCA
B2C	ATTCTTCCTTCCAG
B4B	CACAGCGATGTAGC
P5A	TCTAGTCACGTCAC
FC2	CCGAGTGCGTTAAC
B7A	TCGATGATTCTTCC
B3C	CTGTACTATCACAG
FN2	CCGTAGTTGGACCG
B4D	ATCTGACGAGTCGA
F8A	CATATGACGAGTCA
F7C	CTTATACACCTCAA
P23B	AACAAGTTCGCGCG
F3D	TACCGTCTGGAACC
ZC2	ATGGTTATGTGGCA
B2	TCTCGCGGTCAAGC
B4C	AAGCATATTCATGG
FN4	ACACGAGCGACGCA
C5A	TTCGGCGTTGGACC
B7B	CAGCGTATCTATCA